filetype.php	获取文件类型的演示
filepro.php	获取文件属性的演示
pathinfo.php	文件信息
basename.php	函数basename()返回路径中的文件名部分
dirname.php	返回去掉文件名后的目录名
readdir.php	遍历目录
dirsize.php	统计目录大小
deldir.php	建立和删除目录
copydir.php	复制目录
fwrite.php	写入文件
file_put_contents.php	写入文件
fread.php	读取文件内容
fgets.php	单行读取文件
fgetc.php	单字符读取文件
fopen_url.php	读取远程文件
ftell.php	移动文件指针
message.php	文件的锁定机制
fileoption.php	文件操作
upload.php	文件上传过程
up.html		文件上传表单
download.php	文件下载处理
upload目录	文件上传类的实例演示
fileSystem_demo	一个文件系统程序的演示代码（以面向对象的思想实现）
